SSSSSSSSSSSSSSSSSSSSSSSSSSSSSSSSSSSS
SSSSSSSSSSSSSSSSSSSSSSSSSSSSSSSSSSSS
SSSSS                           SSSS
SSSSS                           SSSS
SSSSS                           SSSS
SSSSS                           SSSS
SSSSS                           SSSS
SSSSS                           SSSS
SSSSS                           SSSS
SSSSTO                       B  SSSS
SSSSSSDSSSSSSSSSSSSSSSSSSSSSSSSSSSSS
SSSSSSSSSSSSSSSSSSSSSSSSSSSSSSSSSSSS
SSSSSSSSSSSSSSSSSSSSSSSSSSSSSSSSSSSS
SSSSSSSSSSSSSSSSSSSSSSSSSSSSSSSSSSSS

hats
SHIELD 1
CHICKEN 1
MIND_CONTROL 1