SSSSSSSSSSSSSSSSSSSSSSSSS
SSSSSSSSSSSSSSSSSSSSSSSSS
SSSSSSSSSSSSSSSSSSSSSSSSS
SSSSSSSSSSSSSSSSSSSSSSSSS
SSSSS               SSSSS
SSSSS               SSSSS
SSSSS               SSSSS
SSSSS               SSSSS
SSSSS               SSSSS
SSSSS               SSSSS
SSSSS               SSSSS
SSSSTO           B  SSSSS
SSSSSSSSSSSSSSSSSSSSSSSSS
SSSSSSSSSSSSSSSSSSSSSSSSS
SSSSSSSSSSSSSSSSSSSSSSSSS
SSSSSSSSSSSSSSSSSSSSSSSSS

hats
SHIELD 1
CHICKEN 1
MIND_CONTROL 1