SSSSSSSSSSSSSSSSSSSSSSSSSSSSSSSSSSSSSSSSSSSSSSSSSSSSSSSSSSSSSSSSSSSSSSSSSSSSSSSSSSSSSSSSSSSSSSSSSSSSS
SSSSSSSSSSSSSSSSSSSSSSSSSSSSSSSSSSSSSSSSSSSSSSSSSSSSSSSSSSSSSSSSSSSSSSSSSSSSSSSSSSSSSSSSSSSSSSSSSSSSS
SSSSSSSSSS                                                                                      SSSSS
SSSSSSSSSS                                                               CV                     SSSSS
SSSSSSSSSS                                                  SSSSSS    SSSSSSS                   SSSSS
SSSSSSSSSS                                                                                      SSSSS
SSSSSSSSSS                         SSS            SSSSSS                                        SSSSS
SSSSSSSSSS                  S  S         S  S                     SSS  SSS  SSS  SSS            SSSSS
SSSSSSSSSSTO       ESS     SS  SS   E   SS  SSSSS        S  E  S                 SSSSSS         SSSSS
SSSSSSSSSSSSSDSSDSSSSSSSSSSSSSSSSSSSSSSSSS  SSSSSKKKKKKKKSSSSSSS                 SSSSSSSSSDDDSSSSSSSS
SSSSSSSSSSSSSDDDDSSSSSSSSSSSSSSSSSSSSSSSSSKKSSSSSSSSSSSSSSSSSSSSKKKKKKKKKKKKKKKKKSSSSSSSSSDDDSSSSSSSS
SSSSSSSSSSSSSSSSSSSSSSSSSSSSSSSSSSSSSSSSSSSSSSSSSSSSSSSSSSSSSSSSSSSSSSSSSSSSSSSSSSSSSSSSSSDDDSSSSSSSS
SSSSSSSSSSSSSSSSSS              SSSSSSSSSSSSSSSSSS                         SSSS                 SSSSS
SSSSSSSSSSSSSSSSSS           D   SSSSSSSSSSSSSSSSSD       D E D            SSSS           F     SSSSS
SS    SSSSSSSSSSSS           SS         SS       DDSSSS   SSSSS            SSSSE         SSSSS  SSSSS
SS    DDDDDDDSSSSS           SSS        SSD      DSSSSSS  S E SD     D     SSSSDDDDD            SSSSS
SS    SSSSSSDDDDDD           SSSS       SSDD    DDSSSSSSSDSSDSSDS   DDD    SSSSDDDDDD           SSSSS
SS   SSSSSSSSSSSSS           DDDDD      SSSSSDDSSSSSSSSSSDDDDDDDSS DDDDD   SSSSDDDDDDDV         SSSSS
SS    SSSSSSSSSSSS           SSSSSDDD E   V      CSSSSSSSSDDDDDSSSSSSSSSSDDSSSSDDSSSSSSSSSSSSSSSSSSSS
SSS   SSSSSSSSSSSSSSSDDDSSKKKSSSSSDDDDDDDDDDDDDDDDSSSSSSSSSDDDSSSSSSSSSSSSDDDDDDSSSSSSSSSSSSSSSSSSSSS
SS    SSSSSSSSSSSSSSSDDDSSSSSSSSSSKKKKKKKKKKKKKKKKSSSSSSSSSSSSSSSSSSSSSSSSSDDDDSSSSSSSSSSSSSSSSSSSSSS
SS   SSSSSSSSSSSSSSSSDDDSSSSSSSSSSSSSSSSSSSSSSSSSSSSSSSSSSSSSSSSSSSSSSSSSSSSSSSSSSSSSSSSSSSSSSSSSSSSS
SS    SSSSSSSSSSSS                                  SS                    SSSSSSSSSSSSSSSSSSSSSSSSSSS
SSS   SSSSSSSSSSSS               F                  SS                    SSSSSSSSSSSSSSSSSSSSSSSSSSS
SS    SSSSSSSSSSSS              SSS   E   S   E   SSSS                    SSSSSSSSSSSSSSSSSSSSSSSSSSS
SS   SSSSSSSSSSSSS             SSSSSDDDDDDDDDDDDDDDDSS                    SSSSSSSSSSSSSSSSSSSSSSSSSSS
SSV   SSSSSSSSSSSSSS     SSSSSSSSSSSSSSSSSSDDDDDDDDDSS                    SSSSSSSSSSSSSSSSSSSSSSSSSSS
SSS   SSSSSSSSSSSS   SSS   SSSSSSDDDDDDDDDDDD   E   SS                    SSSSSSSSSSSSSSSSSSSSSSSSSSS
SS   CSSSSSSSSSSSSK       KSSSSSSDDSSSSSSSSSSSSSSSSSSS       S  S         SSSSSSSSSSSSSSSSSSSSSSSSSSS
SS   SSSSSSSSSSSSSS       SSSSSSS                           SS  SS        SSSSSSSSSSSSSSSSSSSSSSSSSSS
SSKKKKSSSSSSSSSSSSSKKKKKKKSSSSSSS                         ESSSKKSSS  VN  GSSSSSSSSSSSSSSSSSSSSSSSSSSS
SSSSSSSSSSSSSSSSSSSSSSSSSSSSSSSSSSSSSSSSSSSSSSSSSSSSSSSSSSSSSSSSSSSSSSSSSSSSSSSSSSSSSSSSSSSSSSSSSSSSS
SSSSSSSSSSSSSSSSSSSSSSSSSSSSSSSSSSSSSSSSSSSSSSSSSSSSSSSSSSSSSSSSSSSSSSSSSSSSSSSSSSSSSSSSSSSSSSSSSSSSS

dialog
Borin: Mmmmm.... Pancakes....
Borin: If only I could dig this dirt.
Borin: Why did I get all of these spikes installed again?
Borin: Ooooh. I found a secret!
Toad : I beat ya! But our princess is in another castle.

pancakes
0
1
2

checkpoints
1
2