SSSSSSSSSSSSSSSSSSSSSSSSSSSSSSSSSSSSSSSSSSSSSSSSSSSSSSSSSSSSSSSSSSSSSSSSSSSSSSSSSSSSSSSSSSSSSSSSSSSSS
SSSSSSSSSSSSSSSSSSSSSSSSSSSSSSSSSSSSSSSSSSSSSSSSSSSSSSSSSSSSSSSSSSSSSSSSSSSSSSSSSSSSSSSSSSSSSSSSSSSSS
SSSSSSSSSS                                                                                      SSSSS
SSSSSSSSSS     B                                                         C                      SSSSS
SSSSSSSSSS                                                  SSSSSS    SSSSSSS                   SSSSS
SSSSSSSSSS     P                                                                                SSSSS
SSSSSSSSSS                         SSS            SSSSSS                                        SSSSS
SSSSSSSSSS P                S  S         S  S                     SSS  SSS  SSS  SSS            SSSSS
SSSSSSSSSSTO P     ESS     SS  SS   E   SS  SSSSS        S  E  S                 SSSSSS         SSSSS
SSSSSSSSSSSSSDSSDSSSSSSSSSSSSSSSSSSSSSSSSS  SSSSSKKKKKKKKSSSSSSS                 SSSSSSSSSDDDSSSSSSSS
SSSSSSSSSSSSSDDDDSSSSSSSSSSSSSSSSSSSSSSSSSKKSSSSSSSSSSSSSSSSSSSSKKKKKKKKKKKKKKKKKSSSSSSSSSDDDSSSSSSSS
SSSSSSSSSSSSSSSSSSSSSSSSSSSSSSSSSSSSSSSSSSSSSSSSSSSSSSSSSSSSSSSSSSSSSSSSSSSSSSSSSSSSSSSSSSDDDSSSSSSSS
SSSSSSSSSSSSSSSSSS              SSSSSSSSSSSSSSSSSS                         SSSS                 SSSSS
SSSSSSSSSSSSSSSSSS           D   SSSSSSSSSSSSSSSSSD       D E D            SSSS           F     SSSSS
SS    SSSSSSSSSSSS           SS         SS       DDSSSS   SSSSS            SSSSE         SSSSS  SSSSS
SS    DDDDDDDSSSSS           SSS        SSD      DSSSSSS  S E SD     D     SSSSDDDDD            SSSSS
SS    SSSSSSDDDDDD           SSSS       SSDD    DDSSSSSSSDSSDSSDS   DDD    SSSSDDDDDD           SSSSS
SS   SSSSSSSSSSSSS           DDDDD      SSSSSDDSSSSSSSSSSDDDDDDDSS DDDDD   SSSSDDDDDDD          SSSSS
SS    SSSSSSSSSSSS           SSSSSDDD E          CSSSSSSSSDDDDDSSSSSSSSSSDDSSSSDDSSSSSSSSSSSSSSSSSSSS
SSS   SSSSSSSSSSSSSSSDDDSSKKKSSSSSDDDDDDDDDDDDDDDDSSSSSSSSSDDDSSSSSSSSSSSSDDDDDDSSSSSSSSSSSSSSSSSSSSS
SS    SSSSSSSSSSSSSSSDDDSSSSSSSSSSKKKKKKKKKKKKKKKKSSSSSSSSSSSSSSSSSSSSSSSSSDDDDSSSSSSSSSSSSSSSSSSSSSS
SS   SSSSSSSSSSSSSSSSDDDSSSSSSSSSSSSSSSSSSSSSSSSSSSSSSSSSSSSSSSSSSSSSSSSSSSSSSSSSSSSSSSSSSSSSSSSSSSSS
SS    SSSSSSSSSSSS                                  SS                    SSSSSSSSSSSSSSSSSSSSSSSSSSS
SSS   SSSSSSSSSSSS               F                  SS                    SSSSSSSSSSSSSSSSSSSSSSSSSSS
SS    SSSSSSSSSSSS              SSS   E   S   E   SSSS                    SSSSSSSSSSSSSSSSSSSSSSSSSSS
SS   SSSSSSSSSSSSS             SSSSSDDDDDDDDDDDDDDDDSS                    SSSSSSSSSSSSSSSSSSSSSSSSSSS
SS    SSSSSSSSSSSSSS     SSSSSSSSSSSSSSSSSSDDDDDDDDDSS                    SSSSSSSSSSSSSSSSSSSSSSSSSSS
SSS   SSSSSSSSSSSS   SSS   SSSSSSDDDDDDDDDDDD   E   SS                    SSSSSSSSSSSSSSSSSSSSSSSSSSS
SS   CSSSSSSSSSSSSK       KSSSSSSDDSSSSSSSSSSSSSSSSSSS       S  S         SSSSSSSSSSSSSSSSSSSSSSSSSSS
SS   SSSSSSSSSSSSSS       SSSSSSS                           SS  SS        SSSSSSSSSSSSSSSSSSSSSSSSSSS
SSKKKKSSSSSSSSSSSSSKKKKKKKSSSSSSS                         ESSSKKSSS   N  GSSSSSSSSSSSSSSSSSSSSSSSSSSS
SSSSSSSSSSSSSSSSSSSSSSSSSSSSSSSSSSSSSSSSSSSSSSSSSSSSSSSSSSSSSSSSSSSSSSSSSSSSSSSSSSSSSSSSSSSSSSSSSSSSS
SSSSSSSSSSSSSSSSSSSSSSSSSSSSSSSSSSSSSSSSSSSSSSSSSSSSSSSSSSSSSSSSSSSSSSSSSSSSSSSSSSSSSSSSSSSSSSSSSSSSS