UUUUUUUUUUUUUUUUUUUUUUUUUUUUUUUUUUUUUUUUUUUUUUUUUUUUUUUUUUUUUUUUUUUUUUUUUUUUUUUUUUUUUUUUUUUUUUUUUUUUUUUUU
UUUUUUUUUUUUUUUUUUUUUUUUUUUUUUUUUUUUUUUUUUUUUUUUUUUUUUUUUUUUUUUUUUUUUUUUUUUUUUUUUUUUUUUUUUUUUUUUUUUUUUUUU
UUUUUUUUUU                                                                                          UUUUU
UUUUUUUUUU                                                                  CV                      UUUUU
UUUUUUUUUU                                                    SSSSSSS    SSSSSSS                    UUUUU
UUUUUUUUUU                                                                                          UUUUU
UUUUUUUUUU    H          H            SSS            SSSSSS                                     H   UUUUU
UUUUUUUUUU                     U  U         U  U                     SSS  SSS  SSS  UUU             UUUUU
UUUUUUUUUUTO         EUU      UU  UU   E   UU  UUUUU        S  E  S                 UUUUUU          UUUUU
UUUUUUUUUUUUUDUUUUDUUUUUUUUUUUUUUUUUUUUUUUUUU  UUUUUKKKKKKKKUUUUUUU                 UUUUUUUUUDDDUUUUUUUUU
UUUUUUUUUUUUUDDDDDDUUUUUUUUUUUUUUUUUUUUUUUUUUKKUUUUUUUUUUUUUUUUUUUUKKKKKKKKKKKKKKKKKUUUUUUUUUDDDUUUUUUUUU
UUUUUUUUUUUUUUUUUUUUUUUUUUUUUUUUUUUUUUUUUUUUUUUUUUUUUUUUUUUUUUUUUUUUUUUUUUUUUUUUUUUUUUUUUUUUUDDDUUUUUUUUU
UUUUUUUUUUUUUUUUUUUU               UUUUUUUUUUUUUUUUUU                         UUUU                 UUUUUU
UUUUUUUUUUUUUUUUUUUU            D   UUUUUUUUUUUUUUUUUD       D E D            UUUU           FV    UUUUUU
UU    UUUUUUUUUUUUUU            UU         UU       DDUUUU   UUUUU            UUUUE         SSSSS  UUUUUU
UU    DDDDDDDUUUUUUU            UUU        UUD      DUUUUUU  U E UD     D     UUUUDDDDD   H        UUUUUU
UU    UUUUUUDDDDDDDD            UUUU       UUDD    DDUUUUUUUDUUDUUDU   DDD    UUUUDDDDDD           UUUUUU
UU   UUUUUUUUUUUUUUU            DDDDD      UUUUUDDUUUUUUUUUUDDDDDDDUU DDDDD   UUUUDDDDDDD          UUUUUU
UU    UUUUUUUUUUUUUU            UUUUUDDD EV        VCUUUUUUUUDDDDDUUUUUUUUUUDDUUUUDDUUUUUUUUUUUUUUUUUUUUU
UUU   UUUUUUUUUUUUUUUUUDDDUUUKKKUUUUUDDDDDDDDDDDDDDDDUUUUUUUUUDDDUUUUUUUUUUUUDDDDDDUUUUUUUUUUUUUUUUUUUUUU
UU    UUUUUUUUUUUUUUUUUDDDUUUUUUUUUUUKKKKKKKKKKKKKKKKUUUUUUUUUUUUUUUUUUUUUUUUUDDDDUUUUUUUUUUUUUUUUUUUUUUU
UU   UUUUUUUUUUUUUUUUUUDDDUUUUUUUUUUUUUUUUUUUUUUUUUUUUUUUUUUUUUUUUUUUUUUUUUUUUUUUUUUUUUUUUUUUUUUUUUUUUUUU
UU    UUUUUUUUUUUUUU                                   UU                    UUUUUUUUUUUUUUUUUUUUUUUUUUUU
UUU   UUUUUUUUUUUUUU                F                  UU                    UUUUUUUUUUUUUUUUUUUUUUUUUUUU
UU    UUUUUUUUUUUUUU               UUU   E   S   E   UUUU                    UUUUUUUUUUUUUUUUUUUUUUUUUUUU
UU   UUUUUUUUUUUUUUU              UUUUUDDDDDDDDDDDDDDDDUU                    UUUUUUUUUUUUUUUUUUUUUUUUUUUU
UUV   UUUUUUUUUUUUUUUU     UUUUUUUUUUUUUUUUUUUDDDDDDDDDUU                    UUUUUUUUUUUUUUUUUUUUUUUUUUUU
UUU   UUUUUUUUUUUUUU   SSS   UUUUUUUDDDDDDDDDDDD   E   UU                    UUUUUUUUUUUUUUUUUUUUUUUUUUUU
UU   CUUUUUUUUUUUUUUK       KUUUUUUUDDUUUUUUUUUUUUUUUUUUU       U  U         UUUUUUUUUUUUUUUUUUUUUUUUUUUU
UU   UUUUUUUUUUUUUUUU       UUUUUUUU                           UU  UU        UUUUUUUUUUUUUUUUUUUUUUUUUUUU
UUKKKKUUUUUUUUUUUUUUUKKKKKKKUUUUUUUU                         EUUUKKUUU  VN  GUUUUUUUUUUUUUUUUUUUUUUUUUUUU
UUUUUUUUUUUUUUUUUUUUUUUUUUUUUUUUUUUUUUUUUUUUUUUUUUUUUUUUUUUUUUUUUUUUUUUUUUUUUUUUUUUUUUUUUUUUUUUUUUUUUUUUU
UUUUUUUUUUUUUUUUUUUUUUUUUUUUUUUUUUUUUUUUUUUUUUUUUUUUUUUUUUUUUUUUUUUUUUUUUUUUUUUUUUUUUUUUUUUUUUUUUUUUUUUUU

signs
.\\Assets\\Textures\\move_sign.png
.\\Assets\\Textures\\jump_sign.png
.\\Assets\\Textures\\diggingUpDown_sign.png
.\\Assets\\Textures\\diggingLeftRight_sign.png

dialog
Borin: Mmmmm.... Pancakes....
Borin: Is this a checkpoint?
Borin: Why did I get all of these spikes installed again? They're dangerous.
Borin: I wonder how many pancakes there are around here.
Borin: Ooooooh. I found a secret!
Toad : I beat ya! But our princess is in another castle.

pancakes
0
1
2

checkpoints
1
2

hats
SHIELD 0
CHICKEN 0
MIND_CONTROL 0