SS                                                                                     SS
SS                                                                                     SS
SS                                                SSSSSSSSS  SSSSSS                    SS
SS                                                                                     SS
SS   SSSS                  SSS            SSSSSS                                       SS
SS                  S  S         S  S                     SSS  SSS  SSS  SSS           SS
SS          SS     SS  SS       SS  SS           S     S                 SSSSS         SS
SSSSSDSSDSSSSSSSSSSSSSSSSSSSSSSSSS  SSSSS        SSSSSSS                 SSSSSSSSDDDSSSSS
SSSSSDDDDSSSSSSSSSSSSSSSSSSSSSSSSSPPSSSSSPPPPPPPPSSSSSSSPPPPPPPPPPPPPPPPPSSSSSSSSDDDSSSSS
SSSSSSSSSSSSSSSSSSSSSSSSSSSSSSSSSSSSSSSSSSSSSSSSSSSSSSSSSSSSSSSSSSSSSSSSSSSSSSSSSDDDSSSSS
SS      SS              SSSSSSSSSSSSSSSSSS                         SSSS                SS
SS      SS           D   SSSSSSSSSSSSSSSSSD       S   S            SSSS                SS
SSSS    SS           SS          S        DSSSS   SSSSS            SSSS         SSSSS  SS
SSSS    SS           SSS         SD       SSSSSS  SSSSSD     D     SSSS                SS
SS    SSSS           SSSS     SSSSDD    DDSSSSSSSDSSSSSDS   DDD    SSSS                SS
SS    SSSS           DDDDD       SSSSDDSSSSSSSSSSDDDDDDDSS DDDDD   SSSS                SS
SS   DDDDD           SSSSSDDD             SSSSSSSSDDDDDSSSSSSSSSSDDSSSSDDSSSSSSSSSSSSSSSS
SSSSSSSSSSSSSDDDSSSPPSSSSSDDDDDDDDDDDDDDDDSSSSSSSSSDDDSSSSSSSSSSSSDDDDDDSSSSSSSSSSSSSSSSS
SSSSSSSSSSSSSDDDSSSSSSSSSSPPPPPPPPPPPPPPPPSSSSSSSSSSDSSSSSSSSSSSSSSDDDDSSSSSSSSSSSSSSSSSS
SSSSSSSSSSSSSDDDSSSSSSSSSSSSSSSSSSSSSSSSSSSSSSSSSSSSSSSSSSSSSSSSSSSSSSSSSSSSSSSSSSSSSSSSS
SSSSSSSSSS                                  SS                    SSSSSSSSSSSSSSSSSSSSSSS
SSSSSSSSSS                                   SS                   SSSSSSSSSSSSSSSSSSSSSSS
SSSSSSSSSS  SS SS       SSS       S       SSSS                    SSSSSSSSSSSSSSSSSSSSSSS
SSSSSSSSSS             SSSSSDDDDDDDDDDDDDDDDSS                    SSSSSSSSSSSSSSSSSSSSSSS
SSSSSSSSSSSS     SS   SSSSSSSSSSSSSDDDDDDDDDSS                    SSSSSSSSSSSSSSSSSSSSSSS
SSSSSSSSSS    S    SSSSSSDDDDDDDDDDDDDDDDDDDSS                    SSSSSSSSSSSSSSSSSSSSSSS
SSSSSSSSSSP       PSSSSSSDDSSSSSSSSSSSSSSSSSSS       S  S         SSSSSSSSSSSSSSSSSSSSSSS
SSSSSSSSSSS       SSSSSSS                           SS  SS        SSSSSSSSSSSSSSSSSSSSSSS
SSSSSSSSSSSPPPPPPPSSSSSSS                          SSSPPSSS       SSSSSSSSSSSSSSSSSSSSSSS
SSSSSSSSSSSSSSSSSSSSSSSSSSSSSSSSSSSSSSSSSSSSSSSSSSSSSSSSSSSSSSSSSSSSSSSSSSSSSSSSSSSSSSSSS