SSSSS                                                                                      SSSSS
SSSSS                                                    C                                 SSSSS
SSSSS                                                SSSSSSSSS  SSSSSS                     SSSSS
SSSSS                                                                                      SSSSS
SSSSS   SSSS                  SSS            SSSSSS                                        SSSSS
SSSSS                  S  S         S  S                     SSS  SSS  SSS  SSS            SSSSS
SSSSSTO       ESS     SS  SS       SS  SS           S  E  S                 SSSSSS         SSSSS
SSSSSSSSDSSDSSSSSSSSSSSSSSSSSSSSSSSSS  SSSSS        SSSSSSS                 SSSSSSSSSDDDSSSSSSSS
SSSSSSSSDDDDSSSSSSSSSSSSSSSSSSSSSSSSSPPSSSSSPPPPPPPPSSSSSSSPPPPPPPPPPPPPPPPPSSSSSSSSSDDDSSSSSSSS
SSSSSSSSSSSSSSSSSSSSSSSSSSSSSSSSSSSSSSSSSSSSSSSSSSSSSSSSSSSSSSSSSSSSSSSSSSSSSSSSSSSSSDDDSSSSSSSS
SSSSS      SS              SSSSSSSSSSSSSSSSSS                         SSSS                 SSSSS
SSSSSC     SS           D   SSSSSSSSSSSSSSSSSD       S E S            SSSS                 SSSSS
SSSSSSS    SS           SS          S        DSSSS   SSSSS            SSSS          SSSSS  SSSSS
SSSSSSS    SS           SSS         SD       SSSSSS  SSSSSD     D     SSSS                 SSSSS
SSSSS    SSSS     E     SSSS     SSSSDD    DDSSSSSSSDSSSSSDS   DDD    SSSS                 SSSSS
SSSSS    SSSS           DDDDD       SSSSDDSSSSSSSSSSDDDDDDDSS DDDDD   SSSS                 SSSSS
SSSSS   DDDDD           SSSSSDDD E          CSSSSSSSSDDDDDSSSSSSSSSSDDSSSSDDSSSSSSSSSSSSSSSSSSSS
SSSSSSSSSSSSSSSSDDDSSSPPSSSSSDDDDDDDDDDDDDDDDSSSSSSSSSDDDSSSSSSSSSSSSDDDDDDSSSSSSSSSSSSSSSSSSSSS
SSSSSSSSSSSSSSSSDDDSSSSSSSSSSPPPPPPPPPPPPPPPPSSSSSSSSSSDSSSSSSSSSSSSSSDDDDSSSSSSSSSSSSSSSSSSSSSS
SSSSSSSSSSSSSSSSDDDSSSSSSSSSSSSSSSSSSSSSSSSSSSSSSSSSSSSSSSSSSSSSSSSSSSSSSSSSSSSSSSSSSSSSSSSSSSSS
SSSSSSSSSSSSS                                  SS                    SSSSSSSSSSSSSSSSSSSSSSSSSSS
SSSSSSSSSSSSS                                  SS                    SSSSSSSSSSSSSSSSSSSSSSSSSSS
SSSSSSSSSSSSS  SS SS       SSS   E   S   E   SSSS                    SSSSSSSSSSSSSSSSSSSSSSSSSSS
SSSSSSSSSSSSS             SSSSSDDDDDDDDDDDDDDDDSS                    SSSSSSSSSSSSSSSSSSSSSSSSSSS
SSSSSSSSSSSSSSS     SS   SSSSSSSSSSSSSDDDDDDDDDSS                    SSSSSSSSSSSSSSSSSSSSSSSSSSS
SSSSSSSSSSSSS    S    SSSSSSDDDDDDDDDDDDDDDDDDDSS                    SSSSSSSSSSSSSSSSSSSSSSSSSSS
SSSSSSSSSSSSSP       PSSSSSSDDSSSSSSSSSSSSSSSSSSS       S  S         SSSSSSSSSSSSSSSSSSSSSSSSSSS
SSSSSSSSSSSSSS       SSSSSSS                           SS  SS        SSSSSSSSSSSSSSSSSSSSSSSSSSS
SSSSSSSSSSSSSSPPPPPPPSSSSSSS                          SSSPPSSS   N  GSSSSSSSSSSSSSSSSSSSSSSSSSSS
SSSSSSSSSSSSSSSSSSSSSSSSSSSSSSSSSSSSSSSSSSSSSSSSSSSSSSSSSSSSSSSSSSSSSSSSSSSSSSSSSSSSSSSSSSSSSSSS