UUUUUUUUUUUUUUUUUUUUUUUUUUUUUUUUUUUUUUUUUUUUUUUUUUUUUUUUUUUUUUUUUUUUUUUUUUUUUUUUUUUUUUUUUUUUUUUUUUUUUUUUUU
UUUUUUUUUUUUUUUUUUUUUUUUUUUUUUUUUUUUUUUUUUUUUUUUUUUUUUUUUUUUUUUUUUUUUUUUUUUUUUUUUUUUUUUUUUUUUUUUUUUUUUUUUU
UUUUUUUUUU                                                                                          UUUUUU
UUUUUUUUUU                                                                                          UUUUUU
UUUUUUUUUU                                                                  CV                      UUUUUU
UUUUUUUUUU                                                    SSSSSSS    SSSSSSS                    UUUUUU
UUUUUUUUUU                                                                                          UUUUUU
UUUUUUUUUU    H                       SSS            SSSSSS                                     H   UUUUUU
UUUUUUUUUU                     U  U         U  U                     SSS  SSS  SSS  UUU             UUUUUU
UUUUUUUUUUTO         EUU      UU  UU   E   UU  UUUUU        S  E  S                 UUUUUU          UUUUUU
UUUUUUUUUUUUUDUUUUDUUUUUUUUUUUUUUUUUUUUUUUUUU  UUUUUKKKKKKKKUUUUUUU                 UUUUUUUUUDDDUUUUUUUUUU
UUUUUUUUUUUUUDDDDDDUUUUUUUUUUUUUUUUUUUUUUUUUUKKUUUUUUUUUUUUUUUUUUUUKKKKKKKKKKKKKKKKKUUUUUUUUUDDDUUUUUUUUUU
UUUUUUUUUUUUUUUUUUUUUUUUUUUUUUUUUUUUUUUUUUUUUUUUUUUUUUUUUUUUUUUUUUUUUUUUUUUUUUUUUUUUUUUUUUUUUDDDUUUUUUUUUU
UUUUUUUUUUUUUUUUUUUU               UUUUUUUUUUUUUUUUUU                         UUUU                 UUUUUUU
UUUUUUUUUUUUUUUUUUUU            D   UUUUUUUUUUUUUUUUUD       D E D            UUUU           FV    UUUUUUU
UU    UUUUUUUUUUUUUU            UU         UU       DDUUUU   UUUUU            UUUUE         SSSSS  UUUUUUU
UU    DDDDDDDUUUUUUU            UUU        UUD      DUUUUUU  U E UD     D     UUUUDDDDD   H        UUUUUUU
UU    UUUUUUDDDDDDDD            UUUU       UUDD    DDUUUUUUUDUUDUUDU   DDD    UUUUDDDDDD           UUUUUUU
UU   UUUUUUUUUUUUUUU            DDDDD      UUUUUDDUUUUUUUUUUDDDDDDDUU DDDDD   UUUUDDDDDDD          UUUUUUU
UU    UUUUUUUUUUUUUU            UUUUUDDD EV        VCUUUUUUUUDDDDDUUUUUUUUUUDDUUUUDDUUUUUUUUUUUUUUUUUUUUUU
UUU   UUUUUUUUUUUUUUUUUDDDUUUKKKUUUUUDDDDDDDDDDDDDDDDUUUUUUUUUDDDUUUUUUUUUUUUDDDDDDUUUUUUUUUUUUUUUUUUUUUUU
UU    UUUUUUUUUUUUUUUUUDDDUUUUUUUUUUUKKKKKKKKKKKKKKKKUUUUUUUUUUUUUUUUUUUUUUUUUDDDDUUUUUUUUUUUUUUUUUUUUUUUU
UU   UUUUUUUUUUUUUUUUUUDDDUUUUUUUUUUUUUUUUUUUUUUUUUUUUUUUUUUUUUUUUUUUUUUUUUUUUUUUUUUUUUUUUUUUUUUUUUUUUUUUU
UU    UUUUUUUUUUUUUU                                   UU                     UUUUUUUUUUUUUUUUUUUUUUUUUUUU
UUU   UUUUUUUUUUUUUU                F                  UU                     UUUUUUUUUUUUUUUUUUUUUUUUUUUU
UU    UUUUUUUUUUUUUU               UUU   E   D   E   UUUU                     UUUUUUUUUUUUUUUUUUUUUUUUUUUU
UU   UUUUUUUUUUUUUUU              UUUUUDDDDDDDDDDDDDDDDUU                     UUUUUUUUUUUUUUUUUUUUUUUUUUUU
UUV   UUUUUUUUUUUUUUUU     UUUUUUUUUUUUUUUUUUUDDDDDDDDDUU                     UUUUUUUUUUUUUUUUUUUUUUUUUUUU
UUU   UUUUUUUUUUUUUU   SSS   UUUUUUUDDDDDDDDDDDD   E   UU                     UUUUUUUUUUUUUUUUUUUUUUUUUUUU
UU   CUUUUUUUUUUUUUUK       KUUUUUUUDDUUUUUUUUUUUUUUUUUUU                     UUUUUUUUUUUUUUUUUUUUUUUUUUUU
UU   UUUUUUUUUUUUUUUU       UUUUUUUUDDDDDDDDDDDDDDDDDDDDD       U  U          UUUUUUUUUUUUUUUUUUUUUUUUUUUU
UUKKKKUUUUUUUUUUUUUUUKKKKKKKUUUUUUUU                           UU  UU         UUUUUUUUUUUUUUUUUUUUUUUUUUUU
UUUUUUUUUUUUUUUUUUUUUUUUUUUUUUUUUUUU                         EUUUKKUUU  VN    GUUUUUUUUUUUUUUUUUUUUUUUUUUU
UUUUUUUUUUUUUUUUUUUUUUUUUUUUUUUUUUUUUUUUUUUUUUUUUUUUUUUUUUUUUUUUUUUUUUUUUUUUUUUUUUUUUUUUUUUUUUUUUUUUUUUUUU
UUUUUUUUUUUUUUUUUUUUUUUUUUUUUUUUUUUUUUUUUUUUUUUUUUUUUUUUUUUUUUUUUUUUUUUUUUUUUUUUUUUUUUUUUUUUUUUUUUUUUUUUUU

signs
.\\Assets\\Textures\\jump_sign.png
.\\Assets\\Textures\\diggingUpDown_sign.png
.\\Assets\\Textures\\diggingLeftRight_sign.png

dialog
Borin: Mmmmm.... Pancakes....
Borin: Is this a checkpoint?
Borin: Why did I get all of these spikes installed again? They're dangerous.
Borin: I wonder how many pancakes there are around here.
Borin: Ooooooh. I found a secret!
Toad : I beat ya! But our princess is in another castle.

pancakes
0
1
2

checkpoints
1
2

hats
SHIELD 0
CHICKEN 0
MIND_CONTROL 0

npcs
.\\Assets\\Textures\\Toad_idle.png 6 0.50 0