SSSSSSSSSSSSSSSSSSSSSSSSSSSSSSSSSSSSSSSSSSSSSSSSSSSSSSSSSSSSSSSSSSSSSSSSSSSSSSSSSSSSSSSSSSSSSSSSSSSSSSSSS
SSSSSSSSSSSSSSSSSSSSSSSSSSSSSSSSSSSSSSSSSSSSSSSSSSSSSSSSSSSSSSSSSSSSSSSSSSSSSSSSSSSSSSSSSSSSSSSSSSSSSSSSS
SSSSSSSSSS                                                                                          SSSSS
SSSSSSSSSS                                                                  CV                      SSSSS
SSSSSSSSSS                                                     SSSSSS    SSSSSSS                    SSSSS
SSSSSSSSSS                                                                                          SSSSS
SSSSSSSSSS    H          H            SSS            SSSSSS                                     H   SSSSS
SSSSSSSSSS                     S  S         S  S                     SSS  SSS  SSS  SSS             SSSSS
SSSSSSSSSSTO         ESS      SS  SS   E   SS  SSSSS        S  E  S                 SSSSSS          SSSSS
SSSSSSSSSSSSSDSSSSDSSSSSSSSSSSSSSSSSSSSSSSSSS  SSSSSKKKKKKKKSSSSSSS                 SSSSSSSSSDDDSSSSSSSSS
SSSSSSSSSSSSSDDDDDDSSSSSSSSSSSSSSSSSSSSSSSSSSKKSSSSSSSSSSSSSSSSSSSSKKKKKKKKKKKKKKKKKSSSSSSSSSDDDSSSSSSSSS
SSSSSSSSSSSSSSSSSSSSSSSSSSSSSSSSSSSSSSSSSSSSSSSSSSSSSSSSSSSSSSSSSSSSSSSSSSSSSSSSSSSSSSSSSSSSSDDDSSSSSSSSS
SSSSSSSSSSSSSSSSSSSS               SSSSSSSSSSSSSSSSSS                         SSSS                 SSSSSS
SSSSSSSSSSSSSSSSSSSS            D   SSSSSSSSSSSSSSSSSD       D E D            SSSS           FV    SSSSSS
SS    SSSSSSSSSSSSSS            SS         SS       DDSSSS   SSSSS            SSSSE         SSSSS  SSSSSS
SS    DDDDDDDSSSSSSS            SSS        SSD      DSSSSSS  S E SD     D     SSSSDDDDD   H        SSSSSS
SS    SSSSSSDDDDDDDD            SSSS       SSDD    DDSSSSSSSDSSDSSDS   DDD    SSSSDDDDDD           SSSSSS
SS   SSSSSSSSSSSSSSS            DDDDD      SSSSSDDSSSSSSSSSSDDDDDDDSS DDDDD   SSSSDDDDDDD          SSSSSS
SS    SSSSSSSSSSSSSS            SSSSSDDD EV        VCSSSSSSSSDDDDDSSSSSSSSSSDDSSSSDDSSSSSSSSSSSSSSSSSSSSS
SSS   SSSSSSSSSSSSSSSSSDDDSSSKKKSSSSSDDDDDDDDDDDDDDDDSSSSSSSSSDDDSSSSSSSSSSSSDDDDDDSSSSSSSSSSSSSSSSSSSSSS
SS    SSSSSSSSSSSSSSSSSDDDSSSSSSSSSSSKKKKKKKKKKKKKKKKSSSSSSSSSSSSSSSSSSSSSSSSSDDDDSSSSSSSSSSSSSSSSSSSSSSS
SS   SSSSSSSSSSSSSSSSSSDDDSSSSSSSSSSSSSSSSSSSSSSSSSSSSSSSSSSSSSSSSSSSSSSSSSSSSSSSSSSSSSSSSSSSSSSSSSSSSSSS
SS    SSSSSSSSSSSSSS                                   SS                    SSSSSSSSSSSSSSSSSSSSSSSSSSSS
SSS   SSSSSSSSSSSSSS                F                  SS                    SSSSSSSSSSSSSSSSSSSSSSSSSSSS
SS    SSSSSSSSSSSSSS               SSS   E   S   E   SSSS                    SSSSSSSSSSSSSSSSSSSSSSSSSSSS
SS   SSSSSSSSSSSSSSS              SSSSSDDDDDDDDDDDDDDDDSS                    SSSSSSSSSSSSSSSSSSSSSSSSSSSS
SSV   SSSSSSSSSSSSSSSS     SSSSSSSSSSSSSSSSSSSDDDDDDDDDSS                    SSSSSSSSSSSSSSSSSSSSSSSSSSSS
SSS   SSSSSSSSSSSSSS   SSS   SSSSSSSDDDDDDDDDDDD   E   SS                    SSSSSSSSSSSSSSSSSSSSSSSSSSSS
SS   CSSSSSSSSSSSSSSK       KSSSSSSSDDSSSSSSSSSSSSSSSSSSS       S  S         SSSSSSSSSSSSSSSSSSSSSSSSSSSS
SS   SSSSSSSSSSSSSSSS       SSSSSSSS                           SS  SS        SSSSSSSSSSSSSSSSSSSSSSSSSSSS
SSKKKKSSSSSSSSSSSSSSSKKKKKKKSSSSSSSS                         ESSSKKSSS  VN  GSSSSSSSSSSSSSSSSSSSSSSSSSSSS
SSSSSSSSSSSSSSSSSSSSSSSSSSSSSSSSSSSSSSSSSSSSSSSSSSSSSSSSSSSSSSSSSSSSSSSSSSSSSSSSSSSSSSSSSSSSSSSSSSSSSSSSS
SSSSSSSSSSSSSSSSSSSSSSSSSSSSSSSSSSSSSSSSSSSSSSSSSSSSSSSSSSSSSSSSSSSSSSSSSSSSSSSSSSSSSSSSSSSSSSSSSSSSSSSSS

signs
.\\Assets\\Textures\\move_sign.png
.\\Assets\\Textures\\jump_sign.png
.\\Assets\\Textures\\diggingUpDown_sign.png
.\\Assets\\Textures\\diggingLeftRight_sign.png

dialog
Borin: Mmmmm.... Pancakes....
Borin: Is this a checkpoint?
Borin: Why did I get all of these spikes installed again? They're dangerous.
Borin: I wonder how many pancakes there are around here.
Borin: Ooooooh. I found a secret!
Toad : I beat ya! But our princess is in another castle.

pancakes
0
1
2

checkpoints
1
2