SSSSSSSSSSSSSSSSSSSSSSSSSSSSSSSSSSSSSSSSSSSSSSSSSSSSSSSSSSSSSSSSSSSSSSSSSSSSSSSSSSSSSSSSSSSSSSSS
SSSSSSSSSSSSSSSSSSSSSSSSSSSSSSSSSSSSSSSSSSSSSSSSSSSSSSSSSSSSSSSSSSSSSSSSSSSSSSSSSSSSSSSSSSSSSSSS
SSSSS                                                                                      SSSSS
SSSSS     B                                              C                                 SSSSS
SSSSS                                                SSSSSSSSS  SSSSSS                     SSSSS
SSSSS     P                                                                                SSSSS
SSSSS   SSSS                  SSS            SSSSSS                                        SSSSS
SSSSS P       P        S  S         S  S                     SSS  SSS  SSS  SSS            SSSSS
SSSSSTO P     ESSKKKKKSS  SS       SS  SS           S  E  S                 SSSSSS         SSSSS
SSSSSSSSDSSDSSSSSSSSSSSSSSSSSSSSSSSSS  SSSSS        SSSSSSS                 SSSSSSSSSDDDSSSSSSSS
SSSSSSSSDDDDSSSSSSSSSSSSSSSSSSSSSSSSSKKSSSSSKKKKKKKKSSSSSSSKKKKKKKKKKKKKKKKKSSSSSSSSSDDDSSSSSSSS
SSSSSSSSSSSSSSSSSSSSSSSSSSSSSSSSSSSSSSSSSSSSSSSSSSSSSSSSSSSSSSSSSSSSSSSSSSSSSSSSSSSSSDDDSSSSSSSS
SSSSS      SS              SSSSSSSSSSSSSSSSSS                         SSSS                 SSSSS
SSSSSC     SS           D   SSSSSSSSSSSSSSSSSD       S E S            SSSS           F     SSSSS
SSSSSSS    SS           SS          S        DSSSS   SSSSS            SSSSE         SSSSS  SSSSS
SSSSSSS    SS           SSS         SD       SSSSSS  SSSSSD     D     SSSSDDDDD            SSSSS
SSSSS    SSSS           SSSS     SSSSDD    DDSSSSSSSDSSSSSDS   DDD    SSSSDDDDDD           SSSSS
SSSSS    SSSS           DDDDD       SSSSDDSSSSSSSSSSDDDDDDDSS DDDDD   SSSSDDDDDDD          SSSSS
SSSSSSS DDDDD           SSSSSDDD E          CSSSSSSSSDDDDDSSSSSSSSSSDDSSSSDDSSSSSSSSSSSSSSSSSSSS
SSSSSSSSSSSSSSSSDDDSSSKKSSSSSDDDDDDDDDDDDDDDDSSSSSSSSSDDDSSSSSSSSSSSSDDDDDDSSSSSSSSSSSSSSSSSSSSS
SSSSSSSSSSSSSSSSDDDSSSSSSSSSSKKKKKKKKKKKKKKKKSSSSSSSSSSDSSSSSSSSSSSSSSDDDDSSSSSSSSSSSSSSSSSSSSSS
SSSSSSSSSSSSSSSSDDDSSSSSSSSSSSSSSSSSSSSSSSSSSSSSSSSSSSSSSSSSSSSSSSSSSSSSSSSSSSSSSSSSSSSSSSSSSSSS
SSSSSSSSSSSSS                                  SS                    SSSSSSSSSSSSSSSSSSSSSSSSSSS
SSSSSSSSSSSSS               F                  SS                    SSSSSSSSSSSSSSSSSSSSSSSSSSS
SSSSSSSSSSSSS  SS SS       SSS   E   S   E   SSSS                    SSSSSSSSSSSSSSSSSSSSSSSSSSS
SSSSSSSSSSSSS             SSSSSDDDDDDDDDDDDDDDDSS                    SSSSSSSSSSSSSSSSSSSSSSSSSSS
SSSSSSSSSSSSSSS     SS   SSSSSSSSSSSSSDDDDDDDDDSS                    SSSSSSSSSSSSSSSSSSSSSSSSSSS
SSSSSSSSSSSSS    S    SSSSSSDDDDDDDDDDDDDDDDDDDSS                    SSSSSSSSSSSSSSSSSSSSSSSSSSS
SSSSSSSSSSSSSK       KSSSSSSDDSSSSSSSSSSSSSSSSSSS       S  S         SSSSSSSSSSSSSSSSSSSSSSSSSSS
SSSSSSSSSSSSSS       SSSSSSS                           SS  SS        SSSSSSSSSSSSSSSSSSSSSSSSSSS
SSSSSSSSSSSSSSKKKKKKKSSSSSSS                          SSSKKSSS   N  GSSSSSSSSSSSSSSSSSSSSSSSSSSS
SSSSSSSSSSSSSSSSSSSSSSSSSSSSSSSSSSSSSSSSSSSSSSSSSSSSSSSSSSSSSSSSSSSSSSSSSSSSSSSSSSSSSSSSSSSSSSSS
SSSSSSSSSSSSSSSSSSSSSSSSSSSSSSSSSSSSSSSSSSSSSSSSSSSSSSSSSSSSSSSSSSSSSSSSSSSSSSSSSSSSSSSSSSSSSSSS