UUUUUUUUUUUUUUUUUUUUUUUUUUUUUUUUUUUUUUUUUUUUUUUUUUUUUUUUU
UUUUUUUUUUUUUUUUUUUUUUUUUUUUUUUUUUUUUUUUUUUUUUUUUUUUUUUUU
UUEEEEEEEEEEEEEEEEEEEEEE             EEEEEEEEEEEEEEEEEEUU
UUUUUUUUUUUUUUUUUUUUUUUUUUUUUUUUUUUUUUUUUUUUUUUUUUUUUUUUU
UUUUUUUUUUUUUUUUUUUUUUUU             UUUUUUUUUUUUUUUUUUUU
UUUUUUUUUUUUUUUUUUUUUUU  H            UUUUUUUUUUUUUUUUUUU
UUUUUUUUUUUUUUUUUUUUUU                 UUUUUUUUUUUUUUUUUU
UUUUUUUUUUUUUUUT                 O  V   QUUUUUUUUUUUUUUUU
UUUUUUUUUUUUUUUUUUUUUUUUUUUUUUUUUUUUUUUUUUUUUUUUUUUUUUUUU
UUEEEEEEEEEEEEEEEE                      EEEEEEEEEEEEEEEUU
UUUUUUUUUUUUUUUUUUUUUUUUUUUUUUUUUUUUUUUUUUUUUUUUUUUUUUUUU
UUUUUUUUUUUUUUUUUUUUUUUUUUUUUUUUUUUUUUUUUUUUUUUUUUUUUUUUU
UUUUUUUUUUUUUUUUUUUUUUUUUUUUUUUUUUUUUUUUUUUUUUUUUUUUUUUUU

hats
SHIELD 0
CHICKEN 0
MIND_CONTROL 0

dialog
Guess I should follow him.

signs
.\\Assets\\Textures\\move_sign.png