SSSSSSSSSSSSSSSSSSSSSSSSSSSSSSSSSSSSS
SSSSSSSSSSSSSSSSSSSSSSSSSSSSSSSSSSSSS
SSSSSSSSSSSSSSSSSSSSSSSSSSSSSSSSSSSSS
SSSSSSSSSSSSSSSSSSSSSSSSSSSSSSSSSSSSS
SSSSS                           SSSSS
SSSSS                           SSSSS
SSSSS                        N  SSSSS
SSSSS                       O  NSSSSS
SSSSS                 SSSSSSSSSSSSSSS
SSSSS                SSSSSSSSSSSSSSSS
SSSSS               SSSSSSSSSSSSSSSSS
SSSSQ    N     N   SSSSSSSSSSSSSSSSSS
SSSSSSSSSSSSSSSSSSSSSSSSSSSSSSSSSSSSS
SSSSSSSSSSSSSSSSSSSSSSSSSSSSSSSSSSSSS
SSSSSSSSSSSSSSSSSSSSSSSSSSSSSSSSSSSSS
SSSSSSSSSSSSSSSSSSSSSSSSSSSSSSSSSSSSS

hats
SHIELD 0
CHICKEN 0
MIND_CONTROL 0

npcs
.\\Assets\\Textures\\Cornelius_idle.png 4 0.9 0
.\\Assets\\Textures\\Chicken_idle.png 4 0.7 1
.\\Assets\\Textures\\Chicken_idle.png 4 0.8 1