RRRRRRRRRRRRRRRRRRRRRRRR
RRRRRRRRRRRRRRRRRRRRRRRR
RRRRRRRRRRRRRRRRRRRRRRRR
RRRRRRRRRRRRRRRRRRRRRRRR
RRRR                RRRR
RRRR                RRRR
RRRR         N      RRRR
RRRT        O       QRRR
RRRRRRRRRRRRRRRRRRRRRRRR
RRRRRRRRRRRRRRRRRRRRRRRR
RRRRRRRRRRRRRRRRRRRRRRRR
RRRRRRRRRRRRRRRRRRRRRRRR

hats
SHIELD 0
CHICKEN 0
MIND_CONTROL 0

npcs
.\\Assets\\Textures\\Adalbert_idle.png 4 0.8 0