SSSSSSSSSSSSSSSSSSSSSSSSS
SSSSSSSSSSSSSSSSSSSSSSSSS
SSSSSSSSSSSSSSSSSSSSSSSSS
SSSSSSSSSSSSSSSSSSSSSSSSS
SSSSS               SSSSS
SSSSS               SSSSS
SSSSS               SSSSS
SSSSS               SSSSS
SSSSSIIIIIII        SSSSS
SSSSS      I   N    SSSSS
SSSSS      I        SSSSS
SSSSTO     I        SSSSS
SSSSSSSSSSSSSSSSSSSSSSSSS
SSSSSSSSSSSSSSSSSSSSSSSSS
SSSSSSSSSSSSSSSSSSSSSSSSS
SSSSSSSSSSSSSSSSSSSSSSSSS

hats
SHIELD 0
CHICKEN 0
MIND_CONTROL 0

npcs
.\\Assets\\Textures\\Adalbert_ridingidle.png 8 0.8 0