SSSSSSSSSSSSSSSSSSSSSSSSSSSSSSSSSSSSS
SSSSSSSSSSSSSSSSSSSSSSSSSSSSSSSSSSSSS
SSSSSSSSSSSSSSSSSSSSSSSSSSSSSSSSSSSSS
SSSSSSSSSSSSSSSSSSSSSSSSSSSSSSSSSSSSS
SSSSS                           SSSSS
SSSSS                           SSSSS
SSSSS                           SSSSS
SSSSS                       ON  SSSSS
SSSSS                 SSSSSSSSSSSSSSS
SSSSS                SSSSSSSSSSSSSSSS
SSSSS               SSSSSSSSSSSSSSSSS
SSSSQ              SSSSSSSSSSSSSSSSSS
SSSSSSSSSSSSSSSSSSSSSSSSSSSSSSSSSSSSS
SSSSSSSSSSSSSSSSSSSSSSSSSSSSSSSSSSSSS
SSSSSSSSSSSSSSSSSSSSSSSSSSSSSSSSSSSSS
SSSSSSSSSSSSSSSSSSSSSSSSSSSSSSSSSSSSS

hats
SHIELD 0
CHICKEN 0
MIND_CONTROL 0