SSSSSSSSSSSSSSSSSSSSSSSSS
SSSSSSSSSSSSSSSSSSSSSSSSS
SSSSSSSSSSSSSSSSSSSSSSSSS
SSSSSSSSSSSSSSSSSSSSSSSSS
SSSSS               SSSSS
SSSSS               SSSSS
SSSSS               SSSSS
SSSSS               SSSSS
SSSSS               SSSSS
SSSSS          N    SSSSS
SSSSSII             SSSSS
SSSSTOI             SSSSS
SSSSSSSSSSSSSSSSSSSSSSSSS
SSSSSSSSSSSSSSSSSSSSSSSSS
SSSSSSSSSSSSSSSSSSSSSSSSS
SSSSSSSSSSSSSSSSSSSSSSSSS

hats
SHIELD 0
CHICKEN 0
MIND_CONTROL 0

npcs
.\\Assets\\Textures\\Watch_idle.png 4 0.8 0