SSSSSSSSSSSSSSSSSSSSSSSSSSSSSSSSSSSS
SSSSSSSSSSSSSSSSSSSSSSSSSSSSSSSSSSSS
SSSSS           I               SSSS
SSSSS           I               SSSS
SSSSS           I               SSSS
SSSSS           I               SSSS
SSSSS           I               SSSS
SSSSS           I               SSSS
SSSSS           I               SSSS
SSSSTO          IN              GSSS
SSSSSSDSSSSSSSSSSSSSSSSSSSSSSSSSSSSS
SSSSSSSSSSSSSSSSSSSSSSSSSSSSSSSSSSSS
SSSSSSSSSSSSSSSSSSSSSSSSSSSSSSSSSSSS
SSSSSSSSSSSSSSSSSSSSSSSSSSSSSSSSSSSS

hats
SHIELD 1
CHICKEN 1
MIND_CONTROL 1