SSSSSSSSSSSSSSSSSSSSSSSSSSSSSSSSSSSS
SSSSSSSSSSSSSSSSSSSSSSSSSSSSSSSSSSSS
SSSSS           I               SSSS
SSSSS           I               SSSS
SSSSS           I               SSSS
SSSSS           I               SSSS
SSSSS           I               SSSS
SSSSS           I               SSSS
SSSSS           I               SSSS
SSSSTO          IN              GSSS
SSSSSSDSSSSSSSSSSSSSSSSSSSSSSSSSSSSS
SSSSSSSSSSSSSSSSSSSSSSSSSSSSSSSSSSSS
SSSSSSSSSSSSSSSSSSSSSSSSSSSSSSSSSSSS
SSSSSSSSSSSSSSSSSSSSSSSSSSSSSSSSSSSS

hats
SHIELD 0
CHICKEN 0
MIND_CONTROL 0