UUUUUUUUUUUUUUUUUUUUUUUUUUUUUUUUUUUUUUUUUUUUUUUUUUUUUUUUU
UUUUUUUUUUUUUUUUUUUUUUUUUUUUUUUUUUUUUUUUUUUUUUUUUUUUUUUUU
UUEEEEEEEEEEEEEEEEEEEEEE             EEEEEEEEEEEEEEEEEEUU
UUUUUUUUUUUUUUUUUUUUUUUUUUUUUUUUUUUUUUUUUUUUUUUUUUUUUUUUU
UUUUUUUUUUUUUUUUUUUUUUUU         I   UUUUUUUUUUUUUUUUUUUU
UUUUUUUUUUUUUUUUUUUUUUU  H       I    UUUUUUUUUUUUUUUUUUU
UUUUUUUUUUUUUUUUUUUUUU           I     UUUUUUUUUUUUUUUUUU
UUUUUUUUUUUUUUUTO                IN     QUUUUUUUUUUUUUUUU
UUUUUUUUUUUUUUUUUUUUUUUUUUUUUUUUUUUUUUUUUUUUUUUUUUUUUUUUU
UUEEEEEEEEEEEEEEEE                      EEEEEEEEEEEEEEEUU
UUUUUUUUUUUUUUUUUUUUUUUUUUUUUUUUUUUUUUUUUUUUUUUUUUUUUUUUU
UUUUUUUUUUUUUUUUUUUUUUUUUUUUUUUUUUUUUUUUUUUUUUUUUUUUUUUUU
UUUUUUUUUUUUUUUUUUUUUUUUUUUUUUUUUUUUUUUUUUUUUUUUUUUUUUUUU

hats
SHIELD 0                                                 
CHICKEN 0                                                
MIND_CONTROL 0                                                                                              

signs
.\\Assets\\Textures\\move_sign.png                    

npcs
.\\Assets\\Textures\\Toad_idle.png 6 0.50 0              