RRRRRRRRRRRRRRRRRRRRRRRR
RRRRRRRRRRRRRRRRRRRRRRRR
RRRRRRRRRRRRRRRRRRRRRRRR
RRRRRRRRRRRRRRRRRRRRRRRR
RRRR        I       RRRR
RRRR        I       RRRR
RRRR        IN      RRRR
RRRTO       I       QRRR
RRRRRRRRRRRRRRRRRRRRRRRR
RRRRRRRRRRRRRRRRRRRRRRRR
RRRRRRRRRRRRRRRRRRRRRRRR
RRRRRRRRRRRRRRRRRRRRRRRR

hats
SHIELD 0
CHICKEN 0
MIND_CONTROL 0

npcs
.\\Assets\\Textures\\Adalbert_idle.png 4 0.8 0