SSSSSSSSSSSSSSSSSSSSSSSSSSSSSSSSSSSS
SSSSSSSSSSSSSSSSSSSSSSSSSSSSSSSSSSSS
SSSSS                           SSSS
SSSSS                           SSSS
SSSSS                           SSSS
SSSSS                           SSSS
SSSSS                           SSSS
SSSSS                           SSSS
SSSSS                           SSSS
SSSSTO                          GSSS
SSSSSSDSSSSSSSSSSSSSSSSSSSSSSSSSSSSS
SSSSSSSSSSSSSSSSSSSSSSSSSSSSSSSSSSSS
SSSSSSSSSSSSSSSSSSSSSSSSSSSSSSSSSSSS
SSSSSSSSSSSSSSSSSSSSSSSSSSSSSSSSSSSS

hats
SHIELD 0
CHICKEN 0
MIND_CONTROL 0