SSSSSSSSSSSSSSSSSSSSSSSSSSSSSSSSSSSSSSSSSSSSSSSSSSSSSSSSSSSSSSSSSSSSSSSSSSSSSSSSSSSSSSSSSSSSSSSS
SS       SSSSSSSSSSSSSSSSSSSSSSSSSSSSSSSSSSSSSSSSSSSSSSSSSSSSSSSSSSSSSSSSSSSSSSSSSSSSSSSSSSSSSSS
SS   TO                                                                                    SSSSS
SS  SSSS                                                 C    !                            SSSSS
SS            !                      D                                                     SSSSS
SS            !                      D                 S  S                                SSSSS
SS DDDDDDD       H                   D                                                     SSSSS
SS DDDDDDD    !                    S   S            !        SSS  SSS  SSS  SSS            SSSSS
SSKKKKKKKKKKKKKSE                S      S              E  S                                SSSSS
SSSSSSSSSSSSSSSSSSSSSSSSSSSSSSSSSSKK   KSSS         !SSSSSS                               !SSSSS
SSSSSSSSSSSSSSSSSSSSSSSSSSSSSSSSSSSSKKKSSSSSSSSSSSSSSSSSSSSKKKKKKKKKKKKKKKKKSSSSSSSSS     !SSSSS
SSSSSSSSSSSSSSSSSSSSSSSSSSSSSSSSSSSSSSSSSSSSSSSSSSSSSSSSSSSSSSSSSSSSSSSSSSSSSSSSSSSSS     !SSSSS
SSSSS                    S    SSSSSSSSSSSSSSS   D                           S              SSSSS
SSSSS                    S    SSSSSSSSSSSSSSSD  S!     E                    S              SSSSS
SSSSS                  DDD   FDDDDDD         DSSSS   SSSSS                  S              SSSSS
SSSSS              SSSSSDD  !S!    DDDDDDDD   SSSSS  SSSSSD                 S              SSSSS
SSSSS                  DDD  !SSSSS!    DDDD   SSSSSSDSSSSSDS                S              SSSSS
SSSSSN             KKKKKKKK    C!SSSSS!       SSSSSSCDDDDDD!S               S           F  SSSSS
SSSSSSKKKKKSSSSSSDSSSSSSSSSSSSSSSSSSSSSSSSSSSSSSSSSSSSSSSSSSSSSSSSSSDDSSSSSSSSSSSDDSSSSSSSSSSSSS
SSSSSSSSSSSSSSSSSDSSSSSSSSSSSSSSSSSSSSSSSSSSSSSSSSSSSSSSSSSSSSSSSSSSD       SSSSSDDSSSSSSSSSSSSS
SSSSSSSSSSSSSSSSSDSSSSSSSSSSSSSSSSSSSSSSSSSSSSSSSSSSSSSSSSSSSSSSSSSSS       SSSDD  SSSSSSSSSSSSS
SSSSSSSSSSSSSSSSSDSSSSSSSSSSSSSSSSSSSSSSSSSSSSSSSSSSSSSSSSSSSSSSSSSSSKSSCSSKSSDDS  SSSSSSSSSSSSS
SSSSSSSSSSSSS  S   S                           SS                    SSSDDDDDDDSSKKSSSSSSSSSSSSS
SSSSSSSSSSSSS  SK KS                          !SS                    SSSSSSSSSSSSSSSSSSSSSSSSSSS
SSSSSSSSSSSSS  SS SS      FSSS   E   S   E   SSSS                   GSSSSSSSSSSSSSSSSSSSSSSSSSSS
SSSSSSSSSSSSS             SSSSSDSSSSSSSSSSSSSSSSS                   DSSSSSSSSSSSSSSSSSSSSSSSSSSS
SSSSSSSSSSSSSSS D D SS   SSSSSS DDSS           SS                   DSSSSSSSSSSSSSSSSSSSSSSSSSSS
SSSSSSSSSSSSS   DKD   SSSSSSSSS D D           !SS                   DSSSSSSSSSSSSSSSSSSSSSSSSSSS
SSSSSSSSSSSSSK   S   KSSSSSSSSSKS SSSSSKKKKSSDSSSDDDDDDDDDDDDDDDDDD DSSSSSSSSSSSSSSSSSSSSSSSSSSS
SSSSSSSSSSSSSS       SSSSSSSSSSSSKSSSSS                             DSSSSSSSSSSSSSSSSSSSSSSSSSSS
SSSSSSSSSSSSSSKKKKKKKSSSSSSS!                       SKKKKKKKKKKS     SSSSSSSSSSSSSSSSSSSSSSSSSSS
SSSSSSSSSSSSSSSSSSSSSSSSSSSSSSSSSSSSSSSSSSSSSSSSSSSSSSSSSSSSSSSSSSSSSSSSSSSSSSSSSSSSSSSSSSSSSSSS
SSSSSSSSSSSSSSSSSSSSSSSSSSSSSSSSSSSSSSSSSSSSSSSSSSSSSSSSSSSSSSSSSSSSSSSSSSSSSSSSSSSSSSSSSSSSSSSS

signs
.\\Assets\\Textures\\shield_sign.png

pancakes
0
3
2
1

checkpoints
2
1

hats
SHIELD 1
CHICKEN 0
MIND_CONTROL 0

npcs
.\\Assets\\Textures\\Toad_idle.png 6 0.50 1

turrets
1
1
0
0
0
0
0
0
0
1
0
1
0
1
0
1
0
0
0
1