SSSSSSSSSSSSSSSSSSSSSSSSSSSSSSSSSSSSSSSSSSSSSSSSSSSSSSSSSSSSSSSSSSSSSSSSSSSSSSSSSSSSSSSSSSSSSSSS
SS       SSSSSSSSSSSSSSSSSSSSSSSSSSSSSSSSSSSSSSSSSSSSSSSSSSSSSSSSSSSSSSSSSSSSSSSSSSSSSSSSSSSSSSS
SS   TO                                                                                    SSSSS
SS  SSSS                                                 C    !                            SSSSS
SS            !                      D                                                     SSSSS
SS            !                      D                 S  S                                SSSSS
SS DDDDDDD                           D                                                     SSSSS
SS DDDDDDD    !                    S   S            !        SSS  SSS  SSS  SSS            SSSSS
SSKKKKKKKKKKKKKSE                S      S              E  S                                SSSSS
SSSSSSSSSSSSSSSSSSSSSSSSSSSSSSSSSSKK   KSSS         !SSSSSS                               !SSSSS
SSSSSSSSSSSSSSSSSSSSSSSSSSSSSSSSSSSSKKKSSSSSSSSSSSSSSSSSSSSKKKKKKKKKKKKKKKKKSSSSSSSSS     !SSSSS
SSSSSSSSSSSSSSSSSSSSSSSSSSSSSSSSSSSSSSSSSSSSSSSSSSSSSSSSSSSSSSSSSSSSSSSSSSSSSSSSSSSSS     !SSSSS
SSSSS                    S    SSSSSSSSSSSSSSS                               S              SSSSS
SSSSS                    S    SSSSSSSSSSSSSSSD         E                    S              SSSSS
SSSSS                  DDD   FDDDDDD         DSSSS   SSSSS                  S              SSSSS
SSSSS              SSSSSDD  !S!    DDDDDDDD   SSSSS  SSSSSD                 S              SSSSS
SSSSS                  DDD  !SSSSS!    DDDD   SSSSSSDSSSSSDS                S              SSSSS
SSSSSG        N    KKKKKKKK    C!SSSSS!       SSSSSSCDDDDDD!S               S           F  SSSSS
SSSSSSSSSSSSSSSSSDSSSSSSSSSSSSSSSSSSSSSSSSSSSSSSSSSSSSSSSSSSSSSSSSSSDDSSSSSSSSSSSDDSSSSSSSSSSSSS
SSSSSSSSSSSSSSSSSDSSSSSSSSSSSSSSSSSSSSSSSSSSSSSSSSSSSSSSSSSSSSSSSSSSD       SSSSSDDSSSSSSSSSSSSS
SSSSSSSSSSSSSSSSSDSSSSSSSSSSSSSSSSSSSSSSSSSSSSSSSSSSSSSSSSSSSSSSSSSSS       SSSDD  SSSSSSSSSSSSS
SSSSSSSSSSSSSSSSSDSSSSSSSSSSSSSSSSSSSSSSSSSSSSSSSSSSSSSSSSSSSSSSSSSSSKSSCSSKSSDDS  SSSSSSSSSSSSS
SSSSSSSSSSSSS  S   S                           SS                    SSSDDDDDDDSSKKSSSSSSSSSSSSS
SSSSSSSSSSSSS  SK KS                           SS                    SSSSSSSSSSSSSSSSSSSSSSSSSSS
SSSSSSSSSSSSS  SS SS       SSS   E   S   E   SSSS                    SSSSSSSSSSSSSSSSSSSSSSSSSSS
SSSSSSSSSSSSS             SSSSSDDDDDDDDDDDDDDDDSS                    SSSSSSSSSSSSSSSSSSSSSSSSSSS
SSSSSSSSSSSSSSS  K  SS   SSSSSSSSSSSSSDDDDDDDDDSS                    SSSSSSSSSSSSSSSSSSSSSSSSSSS
SSSSSSSSSSSSS    S    SSSSSSDDDDDDDDDDDDDDDDDDDSS                    SSSSSSSSSSSSSSSSSSSSSSSSSSS
SSSSSSSSSSSSSK       KSSSSSSDDSSSSSSSSSSSSSSSSSSS       S  S         SSSSSSSSSSSSSSSSSSSSSSSSSSS
SSSSSSSSSSSSSS       SSSSSSS                           SS  SS        SSSSSSSSSSSSSSSSSSSSSSSSSSS
SSSSSSSSSSSSSSKKKKKKKSSSSSSS                          SSSKKSSS       SSSSSSSSSSSSSSSSSSSSSSSSSSS
SSSSSSSSSSSSSSSSSSSSSSSSSSSSSSSSSSSSSSSSSSSSSSSSSSSSSSSSSSSSSSSSSSSSSSSSSSSSSSSSSSSSSSSSSSSSSSSS
SSSSSSSSSSSSSSSSSSSSSSSSSSSSSSSSSSSSSSSSSSSSSSSSSSSSSSSSSSSSSSSSSSSSSSSSSSSSSSSSSSSSSSSSSSSSSSSS

pancakes
0
3
2
1

checkpoints
2
1